%%%%%%%%%%%%%%%%%%%%%%%%%%%%%%%%%%%%%
%                                   %
%                       %%%%%%%%%   %
%                       %       %   %
%                       %     %G%   %
%                       %     %%%   %
%                       %           %
%                       %           %
%                       %           %
%                       %           %
%                       %           %
%                       %           %
%     %%%%%%%%%%%%%%%%%%%           %
%                                   %
%                                   %
%                                   %
%     %%%%%%%%%%                    %
%              %                    %
%             S%                    %
%%%%%%%%%%%%%%%%%%%%%%%%%%%%%%%%%%%%%
